Orth	Phon
i	i
y	y
u	u
e	e
ö	ø
o	o
ä	æ
a	ɑ
ii	iː
yy	yː
uu	uː
ee	eː
öö	øː
oo	oː
ää	æː
aa	ɑː
m	m
n	n
ng	ŋ
p	p
b	b
t	t
d	d
k	k
g	ɡ
f	f
s	s
š	ʃ
h	h
v	ʋ
l	l
j	j
r	r
