a	a
á	aː
ä	æ
ä	ɛ
b	b
c	ts
č	tʃ
d	d
ď	ɟ
dz	dz
dž	dʒ
e	ɛ
é	ɛː
f	f
g	g
h	ɦ
ch	x
i	i
í	iː
j	j
k	k
l	l
ľ	ʎ
ĺ	lː
m	m
n	n
ň	ɲ
o	ɔ
ó	ɔː
ô	ʊ̯ɔ
p	p
q	kʋ
r	ɾ
r	r
ŕ	r̩ː
s	s
š	ʃ
t	t
ť	c
u	u
ú	uː
v	v
w	v
x	ks
y	i
ý	iː
z	z
ž	ʒ
