Orth	Phon
а	a
б	b
в	v
г	ɡ
ҕ	ɣ
ҕ	ʁ
д	d
дь	ɟ
е	e
е	je
ё	jo
ж	ʒ
з	z
и	i
й	j
й	ȷ̃
к	k
л	l
м	m
н	n
ҥ	ŋ
нь	ɲ
о	o
ө	ø
п	p
р	ɾ
с	s
һ	h
т	t
у	u
ү	y
ф	f
х	q
х	x
ц	ts
ч	c
ш	ʃ
щ	ɕː
ы	ɯ
э	e
ю	ju
я	ja
