Orth	Phon
а	a
б	b
в	v
г	ɡ
д	d
ђ	dʑ
е	e
ж	ʐ
з	z
и	i
ј	j
к	k
л	l
љ	ʎ
м	m
н	n
њ	ɲ
о	ɔ
п	p
р	ɾ
с	s
т	t
ћ	tɕ
у	u
ф	f
х	x
ц	ts
ч	ʈʂ
џ	ɖʐ
ш	ʂ
