Orth	Phon
a 	a
b 	b
d 	d
ɖ 	ɖ
dz 	d͡z
e 	e
e 	ə
ɛ 	ɛ
f 	f
ƒ 	ɸ
g 	ɡ
gb 	ɡ͡b
ɣ	ɣ
h 	h
i 	i
k 	k
kp 	k͡p
l 	l
m 	m
n 	n
ny 	ɲ
ŋ 	ŋ
o 	o
ɔ 	ɔ
p	p
r 	r
s 	s
t 	t
ts 	t͡s
u 	u
v 	v
ʋ 	β
w 	w
x 	x
y 	j
z	z
̃	̃
