Orth	Phon
i	i
u	y
ou	u
e	e
e	ɛ
eu	ø
eu	œ
a	a
a	ɑ
o	o
o	ɔ
m	m
n	n
gn	ɲ
b	b
d	d
g	g
gw	ɡʷ
gou	ɡʷ
p	p
t	t
k	k
kw	kʷ
kou	kʷ
v	v
zh	z
j	ʒ
c'h	ɣ
c'h	x
f	f
s	s
ch	ʃ
h	h
r	r
y	j
w	w
l	l
lh	ʎ
ae 	aj 
an 	ɑ̃n
añ 	ɑ̃
ao 	aw 
aou 	ɔw
c'hw 	xw
ê 	ɛː
ei 	ɛi̯
eeu 	eø̯
eo 	eː 
eu 	œ
eü 	ɛɥ
eue 	ø̯e
gn 	ɲ
gw 	ɡw
oa 	wa
ôa 	oːa
oe 	wɛ
on 	ɔ̃n
oñ 	ɔ̃
ou 	u
oü 	oy̆
sh 	s 
sk 	sk 
st 	st 
ui 	ɥi
vh 	f
