Orth	Phon
a	a
b	b
c	k
c	t͡s
d	d
e	e
f	f
g	ɡ
h	h
h	_
i	i
j	ʒ
k	k
l	l
m	m
n	n
o	o
p	p
q	k
r	r
s	s
s	z
t	t
u	u
v	v
w	w
w	v
x	ks
y	i
z	z
