Orth	Phon
m	m
bʼ	ɓ
p	pʰ
w	ʋ
n	n
tʼ	tʼ
t	tʰ
tzʼ	tsʼ
tz	tsʰ
x	ʃ
r	ɻ
chʼ	tʃʼ
ch	tʃʰ
j	χ
kʼ	kʼ
k	kʰ
qʼ	qʼ
q	qʰ
ʼ	ʔ
h	h
s	s
l	l
a	a
e	e
i	i
o	o
u	u
d	d
y	j
