Orth	Phon
a	ɑ
b	b
c	dʒ
ç	tʃ
d	d
e	e
ә	æ
f	f
g	ɟ
ğ	ɣ
h	h
x	x
ı	ɯ
i	i
j	ʒ
k	c
k	k
q	ɡ
l	l
m	m
n	n
o	o
ö	ø
p	p
r	r
s	s
ş	ʃ
t	t
u	u
ü	y
v	v
y	j
z	z
