Cyrl	Latn
[а-џ]	[a-z]
а	a
б	b
в	v
г	g
д	d
ђ	dž
е	e
ж	ž
з	z
и	i
ј	j
к	k
л	l
љ	lj
м	m
н	n
њ	nj
о	o
п	p
р	r
с	s
т	t
ћ	ć
у	u
ф	f
х	h
ц	c
ч	č
џ	dz
ш	š
