Orth	Phon
ا	ɑ
ە	ɛ
ە	æ
ب	b
پ	p
ت	t
ج	dʒ
چ	tʃ
خ	χ
د	d
ر	r
ز	z
ژ	ʒ
س	s
ش	ʃ
غ	ʁ
ف	f
ق	q
ك	k
گ	ɡ
ڭ	ŋ
ل	l
م	m
ن	n
ھ	h
و	o
ۇ	u
ۆ	ø
ۈ	y
ۋ	v
ۋ	w
ې	e
ى	ɪ
ى	i
ي	j
