Orth	Phon
а	ɑ
б	b
в	v
г	g
д	d
дж	dʒ
дз	dʑ
е	je
ё	jo
ж	ʒ
з	z
и	i
и	ʲi
і	i
й	j
к	k
л	ɫ
м	m
н	n
о	o
ӧ	ə
п	p
р	r
с	s
т	t
тш	tʃ
у	u
ф	f
х	x
ц	ts
ч	tɕ
ш	ʃ
щ	ɕ
щ	ɕː
ъ	-
ы	ɨ
ь	ʲ
э	e
ю	ju
я	jɑ
