Orth	Phon
a 	ɒ
á 	aː
b 	b
c 	ts
cs 	tʃ 
d 	d
dz 	dz
dzs 	dʒ 
e 	ɛ
é 	eː
f 	f
g 	ɡ
gy 	ɟ
h 	h 
i 	i 
í 	iː
j 	j
k 	k
l 	l
ly 	j
m 	m
n 	n 
ny 	ɲ
o 	o 
ó 	oː
ö 	ø
ő 	øː 
p 	p
r 	r
s 	ʃ
sz 	s
t 	t
ty 	c
u 	u 
ú 	uː
ü 	y 
ű 	yː
v 	v
y 	i 
z 	z
zs 	ʒ
