Orth	Phon
a	a
b	b
d	d
e	e
f	f
g	g
h	h
i	i
j	h
k	k
l	l
m	m
n	n
o	o
p	p
r	r
s	s
t	t
u	u
ua	wa
ue	we
v	v
w	w
x	ʃ
y	j
z	s
ca	ka
ce	se
ci	si
co	ko
cu	ku
qua	kwa
que	ke
qui	ki
quo	kwo
á	a
é	e
í	i
ó	o
ú	u
