Orth	Phon
a	a
é	e
e	ɛ
i	i
i	ı
ô	o
o	ɔ
u	u
b	b
tj	c
tj	ɟ
d	d
f	f
g	g
h	h
j	j
k	k
l	l
p	p
q	q
r	r
s	s
t	t
v	v
w	w
x	x
y	y
z	z
b	ɓ
m	m
n	n
ñ	ŋ
