Orth	Phon
a	a
e	ɛ
i	i
ĩ	e
o	ɔ
u	u
ũ	o
t	t
k	k
mb	ᵐb
nd	ⁿd
ng	ᵑɡ	
nj	ᶮdʒ
m	m
n	n
ny	ɲ
ng'	ŋ
c	ʃ
h	h
b	β
th	ð
g	ɣ
r	ɾ
y	j	
w	w
z	z
f	f	
p	p
s	s
v	v
x	ks
