Orth	Phon
b	b
d	d
f	f
l	l
m	m
n	n
p	p
s	s
t	t
v	v
w	w
y	j
z	z
c	c
j	ɟ
ny	ɲ
ŋ	ŋ
a	a
e	e
i	i
o	o
u	u
k	k
ki	ci
ky	ci
g	g
gi	ɟi
gy	ɟi
nÿ	ɲj
