Orth	Phon
a	a
à	aː
e	ɛ
ee	ɛː
é	e
éé	eː
ë	ə
i	i
ii	iː
o	ɔ
oo	ɔː
ó	o
óó	oː
u	u
uu	uː
b	b
c	c
d	d
f	f
g	ɡ
j	ɟ
k	k
kk	kː
l	l
m	m
mb	mb
n	n
nd	nd
ng	ŋɡ
nj	ɲɟ
ñ	ɲ
ŋ	ŋ
p	p
q	q
r	r
s	s
t	t
w	w
x	x
x	χ
y	j
