Orth	Phon
a	a
e	e
ẹ	ɛ
i	i
o	o
ọ	ɔ
u	u
aa	aː
ee	eː
ẹẹ	ɛː
ii	iː
oo	oː
ọọ	ɔː
uu	uː
b	b
d	d
f	f
g	g
gb	ɡ͡b
h	h
j	d͡ʒ
k	k
l	l
m	m
n	n
n	ŋ̍
p	k͜p
p	p
r	ɾ
s	s
ṣ	ʃ
t	t
w	w
y	j
̀	˨
́	˦
