Orth	Phon
a	a
e	e
i	i
o	o
u	u
m	m 
n	n 
ny	ɲ 
ngʼ	ŋ 
mb	ᵐb 
nd	ⁿd 
nj	ᶮɟ 
ng	ᵑɡ 
p	p 
th	t̪ 
t	t 
ch	c 
k	k 
b	b 
dh	d̪ 
d	d 
j	ɟ 
g	ɡ 
f	f 
s	s 
h	h 
r	r 
w	w 
l	l 
y	j 
