Orth	Phon
a	a
â	aː
b	b
c	k
ch	χ
d	d
dd	ð
e	ɛ
ê	ɛː
f	v
ff	f
g	ɡ
ng	ŋ
h	h
i	ɪ
î	ɪː
j	d͡ʒ
l	l
ll	ɬ
m	m
n	n
o	ɔ
ô	ɔː
p	p
ph	f
r	r
rh	r̥
s	s
t	t
th	θ
u	i
û	iː
w	ʊ
ŵ	ʊː
y	ə
ŷ	əː
