Orth	Phon
a	a
ã	ã
ch	ɕ
e	e
ẽ	ẽ
g	ɰ
gu	w
g̃u	w̃
g̃	ɰ̃
h	h
h	x
i	i
ĩ	ĩ
j	ᵈj
k	k
ku	kʷ
l	l
m	m
mb	ᵐb
n	n
nd	ⁿd
ng	ᵑɡ
ng	ŋ
ngu	ᵑɡʷ
ngu	ŋʷ
nt	nt
ñ	ɲ
o	o
õ	õ
p	p
r	ɾ
rr	r
s	s
t	t
u	u
ũ	ũ
v	ʋ
y	ɨ
ỹ	ɨ̃
ʼ	ʔ
