Orth	Phon
а	a
б	b
в	v
г	ɡ
гв	ɡʷ
гъ	ʁ
гъв	ʁʷ
гъь	ʁʲ
гь	ɡʲ
гӏ	ʕ
гӏв	ʕʷ
д	d
дж	d͡ʒ
джв	d͡ʒʷ
джь	d͡ʑ
дз	d͡z
е	e
ё	jo
ж	ʒ
жв	ʒʷ
жь	ʑ
з	z
и	i
й	j
к	k
кв	kʷ
къ	qʼ
къв	qʷʼ
къь	qʲʼ
кь	kʲ
кӏ	kʼ
кӏв	kʷʼ
кӏь	kʲʼ
л	l
ль	ɮ
лӏ	ɬʼ
м	m
н	n
о	o
п	p
пӏ	pʼ
р	r
с	s
т	t
тл	ɬ
тш	t͡ʃ
тӏ	tʼ
у	w
у	u
ф	f
фӏ	fʼ
х	χ
хв	χʷ
хъ	q
хъв	qʷ
хь	χʲ
хӏ	ħ
хӏв	ħʷ
ц	t͡s
цӏ	t͡sʼ
ч	t͡ɕ
чв	t͡ʃʷ
чӏ	t͡ɕʼ
чӏв	t͡ʃʷʼ
ш	ʃ
шв	ʃʷ
шӏ	t͡ʃʼ
щ	ɕ
ъ	ʔ
ы	ə
э	e
ю	ju
я	ja
