Orth	Phon
a 	a 
b 	b 
ɓ 	ɓ 
c 	tʃ 
d 	d 
ɗ 	ɗ 
e 	e 
f 	ɸ 
g 	ɡ 
h 	h 
i 	i 
j 	dʒ 
j 	ʒ 
k 	k 
ƙ 	kʼ 
l 	l 
m 	m 
n 	n 
o 	o 
r 	r
r 	ɽ 
s 	s 
sh 	ʃ 
t 	t 
ts 	tsʼ 
ts 	sʼ 
u 	u 
w 	w 
y 	j 
ƴ 	ʔʲ 
z 	z 
ʼ	ʔ	
