Orth	Phon
ა	ɑ
ბ	b
გ	ɡ
დ	d
ე	ɛ
ვ	v
ზ	z
ჱ	eɪ
თ	t
ი	i
კ	kʼ
ლ	l
მ	m
ნ	n
ჲ	je
ო	ɔ
პ	pʼ
ჟ	ʒ
რ	r
ს	s
ტ	tʼ
ჳ	uɪ
უ	u
ჷ	ə
ფ	pʰ
ქ	kʰ
ღ	ɣ
ყ	qʼ
ჸ	ʔ
შ	ʃ
ჩ	tʃʰ
ც	tsʰ
ძ	dz
წ	tsʼ
ჭ	tʃʼ
ხ	χ
ჴ	qʰ
ჯ	dʒ
ჰ	h
ჵ	oː
