Orth	Phon
a	a
á	aː
e	ɛ
é	ɛː
ě	ɛ
ě	jɛ
i	ɪ
í	iː
o	o
ó	oː
u	u
ú	uː
ů	uː
y	ɪ
ý	iː
b	b
c	t͡s
č	t͡ʃ
d	d
ď	ɟ
f	f
g	ɡ
h	ɦ
ch	x
j	j
k	k
l	l
m	m
n	n
ň	ɲ
p	p
r	r
ř	r̝
s	s
š	ʃ
t	t
ť	c
v	v
x	ks
x	gz
z	z
ž	ʒ
