Orth	Phon
b 	b
ch 	tʃ
d 	d
f 	f
g 	ɡ
gb 	ɡ͡b
gh 	ɣ
gw 	ɡʷ
h 	ɦ
j 	dʒ
k 	k
kp 	k͡p
kw 	kʷ
l 	l
m 	m
n 	n
ṅ 	ŋ
nw 	ŋʷ
ny 	ɲ
p 	p
r 	r
s 	s
sh 	ʃ
t 	t
v 	v
w 	w
y 	j
z 	z
oo	oː
ọọ	ɔː
ọọ 	ɔː
aa	aː
ee	eː
ii	iː
ịị 	ɪː
ịị 	ɪː
uu	uː
ụụ 	ʊː
ụụ	ʊː
a 	a
e 	e
i 	i
ị 	ɪ
ị 	ɪ
o 	o
ọ 	ɔ
ọ 	ɔ
u 	u
ụ 	ʊ
ụ 	ʊ
